1111111111111111111111111111
1000000000000000000000000011
100000E000000000000000000011
1000000P00000000000000000011
1000000C00000000000000000011
1000000000000000000000000011
1000000000000000000000000011
1111111111111111111111111111