1111111111111111111111111111111111
1E1000000000000C00000C000000000001
1000010100100000101011000000010101
1110010010101010001001100000010101
1P0000000C00C0000000000000000000C1
1111111111111111111111111111111111