111111111111111111
100000000000000011
100000E00000000011
1000000P0000000011
1000000C0000000011
100000000000000011
111111111111111111